//MAP CONVERTED BY dmm2tgm.py THIS HEADER COMMENT PREVENTS RECONVERSION, DO NOT REMOVE
"a" = (
/turf/template_noop,
/area/template_noop)
"b" = (
/turf/closed/wall/mineral/titanium,
/area/shuttle/arrival)
"c" = (
/obj/machinery/cryopod{
	dir = 1
	},
/turf/open/floor/mineral/plastitanium,
/area/shuttle/arrival)
"d" = (
/obj/effect/spawner/structure/window/reinforced/shuttle,
/turf/open/floor/plating,
/area/shuttle/arrival)
"e" = (
/obj/docking_port/mobile/arrivals{
	dir = 1;
	dwidth = 4;
	width = 9;
	height = 19;
	id = "Site 404 Arrival Shuttle"
	},
/turf/template_noop,
/area/template_noop)
"f" = (
/obj/structure/fluff{
	icon_state = "blackbox";
	name = "A.S.A.S. Server";
	desc = "The Arrival Shuttle Autopilot System server. They didn't even bother to invest in a shuttle pilot?"
	},
/turf/open/floor/mineral/plastitanium,
/area/shuttle/arrival)
"g" = (
/obj/machinery/computer/shuttle,
/obj/machinery/light/cold/no_nightlight/directional/east,
/turf/open/floor/mineral/plastitanium,
/area/shuttle/arrival)
"h" = (
/obj/structure/chair/comfy/shuttle{
	dir = 8
	},
/turf/open/floor/mineral/plastitanium,
/area/shuttle/arrival)
"i" = (
/obj/structure/shuttle/engine/propulsion/burst/right,
/obj/structure/window/reinforced/spawner/north,
/turf/open/floor/plating,
/area/shuttle/arrival)
"j" = (
/obj/machinery/cryopod{
	dir = 2
	},
/turf/open/floor/mineral/plastitanium,
/area/shuttle/arrival)
"k" = (
/obj/machinery/light/cold/no_nightlight/directional/west,
/obj/structure/rack/shelf,
/turf/open/floor/iron/smooth,
/area/shuttle/arrival)
"l" = (
/obj/structure/table/reinforced,
/obj/machinery/light/cold/no_nightlight/directional/west,
/turf/open/floor/iron/smooth,
/area/shuttle/arrival)
"m" = (
/obj/structure/shuttle/engine/propulsion/burst/left,
/obj/structure/window/reinforced/spawner/north,
/turf/open/floor/plating,
/area/shuttle/arrival)
"n" = (
/obj/structure/closet/emcloset,
/obj/machinery/light/cold/no_nightlight/directional/south,
/turf/open/floor/mineral/titanium/tiled/white,
/area/shuttle/arrival)
"p" = (
/obj/structure/table/reinforced,
/obj/machinery/light/cold/no_nightlight/directional/west,
/turf/open/floor/mineral/plastitanium,
/area/shuttle/arrival)
"q" = (
/obj/effect/landmark{
	name = "JoinLateCryo"
	},
/turf/open/floor/mineral/titanium/tiled/white,
/area/shuttle/arrival)
"r" = (
/turf/closed/wall/mineral/titanium/nodiagonal,
/area/shuttle/arrival)
"s" = (
/obj/structure/table/reinforced,
/turf/open/floor/mineral/plastitanium,
/area/shuttle/arrival)
"t" = (
/turf/open/floor/iron/smooth,
/area/shuttle/arrival)
"u" = (
/obj/structure/chair/comfy/shuttle{
	dir = 1
	},
/obj/machinery/light/cold/no_nightlight/directional/east,
/turf/open/floor/mineral/plastitanium,
/area/shuttle/arrival)
"v" = (
/obj/structure/chair/comfy/shuttle{
	dir = 4
	},
/turf/open/floor/mineral/plastitanium,
/area/shuttle/arrival)
"w" = (
/obj/structure/closet/wardrobe/black,
/turf/open/floor/mineral/plastitanium,
/area/shuttle/arrival)
"x" = (
/obj/structure/closet/firecloset,
/obj/machinery/light/cold/no_nightlight/directional/south,
/turf/open/floor/mineral/titanium/tiled/white,
/area/shuttle/arrival)
"y" = (
/obj/structure/chair/comfy/shuttle{
	dir = 1
	},
/obj/machinery/light/cold/no_nightlight/directional/west,
/turf/open/floor/mineral/plastitanium,
/area/shuttle/arrival)
"z" = (
/obj/machinery/cryopod{
	dir = 4
	},
/turf/open/floor/mineral/plastitanium,
/area/shuttle/arrival)
"A" = (
/obj/structure/chair/comfy/shuttle,
/obj/machinery/light/cold/no_nightlight/directional/east,
/turf/open/floor/mineral/plastitanium,
/area/shuttle/arrival)
"B" = (
/obj/structure/chair/comfy/shuttle{
	dir = 1
	},
/turf/open/floor/mineral/titanium/tiled/white,
/area/shuttle/arrival)
"C" = (
/obj/structure/chair/comfy/shuttle,
/obj/machinery/light/cold/no_nightlight/directional/west,
/turf/open/floor/mineral/plastitanium,
/area/shuttle/arrival)
"E" = (
/obj/machinery/light/cold/no_nightlight/directional/east,
/turf/open/floor/mineral/titanium/tiled/white,
/area/shuttle/arrival)
"I" = (
/obj/machinery/door/airlock/shuttle,
/turf/open/floor/mineral/titanium/white,
/area/shuttle/arrival)
"M" = (
/obj/structure/closet/wardrobe/grey,
/turf/open/floor/mineral/plastitanium,
/area/shuttle/arrival)
"P" = (
/obj/machinery/requests_console/directional/north{
	department = "Arrival shuttle"
	},
/turf/open/floor/mineral/titanium/tiled/white,
/area/shuttle/arrival)
"S" = (
/turf/open/floor/mineral/titanium/tiled/white,
/area/shuttle/arrival)
"W" = (
/obj/machinery/light/cold/no_nightlight/directional/south,
/turf/open/floor/mineral/titanium/tiled/white,
/area/shuttle/arrival)
"X" = (
/obj/machinery/power/smes,
/turf/open/floor/iron/smooth,
/area/shuttle/arrival)

(1,1,1) = {"
r
b
b
b
b
r
a
a
a
a
a
b
b
d
d
d
d
b
b
"}
(2,1,1) = {"
b
p
z
z
p
b
b
b
b
b
d
b
s
v
v
v
v
s
m
"}
(3,1,1) = {"
b
j
q
q
c
b
l
X
k
b
x
b
A
S
S
S
S
u
m
"}
(4,1,1) = {"
b
j
q
q
c
b
t
t
t
b
S
b
b
b
I
b
b
b
b
"}
(5,1,1) = {"
b
w
S
S
M
b
b
I
b
b
P
I
S
S
S
S
W
b
e
"}
(6,1,1) = {"
r
b
b
I
b
b
S
S
S
I
S
b
b
b
I
b
b
b
b
"}
(7,1,1) = {"
a
d
f
S
S
S
S
S
S
b
n
b
C
S
S
S
S
y
i
"}
(8,1,1) = {"
a
d
g
B
S
S
S
E
b
b
d
b
s
h
h
h
h
s
i
"}
(9,1,1) = {"
a
b
b
b
I
I
b
b
b
a
a
b
b
d
d
d
d
b
b
"}
