//MAP CONVERTED BY dmm2tgm.py THIS HEADER COMMENT PREVENTS RECONVERSION, DO NOT REMOVE
"b" = (
/obj/structure/railing{
	dir = 10
	},
/obj/structure/table,
/turf/open/floor/iron/ported/techfloor,
/area/shuttle/site404/lift106)
"d" = (
/obj/structure/railing{
	dir = 8
	},
/obj/structure/chair/comfy/shuttle{
	dir = 4
	},
/turf/open/floor/iron/ported/techfloor_grid,
/area/shuttle/site404/lift106)
"m" = (
/obj/structure/railing,
/obj/machinery/computer/shuttle/site404/lift106{
	dir = 1
	},
/obj/docking_port/mobile/elevator{
	id = "lift106";
	height = 4;
	dwidth = 1;
	width = 3;
	name = "Site 404 - SCP-106 Access Lift"
	},
/turf/open/floor/iron/ported/techfloor_grid,
/area/shuttle/site404/lift106)
"s" = (
/turf/open/floor/iron,
/area/shuttle/site404/lift106)
"u" = (
/obj/structure/railing{
	dir = 6
	},
/obj/structure/table,
/turf/open/floor/iron/ported/techfloor,
/area/shuttle/site404/lift106)
"S" = (
/obj/structure/railing{
	dir = 4
	},
/obj/structure/chair/comfy/shuttle{
	dir = 8
	},
/turf/open/floor/iron/ported/techfloor_grid,
/area/shuttle/site404/lift106)

(1,1,1) = {"
d
d
d
b
"}
(2,1,1) = {"
s
s
s
m
"}
(3,1,1) = {"
S
S
S
u
"}
